../images/tileset_rocks_40x40.png
40 40 10 4 0 200
3 3 3 3 4 4 4 4 4 4 4 4 4 4 4 4 4 4 4 4 4 4 4 4 4 4 4 4 4 4 4 4 4 4 4 4 4 4 3 4 4 4 4 4 4 4 4 4 4 4 4 4 4 4 4 4 4 4 4 3 3 3 3 3 3 3 3 3 3 4 4 4 4 4 4 4 4 4 4 4 4 4 4 4 4 4 4 4 4 4 4 4 4 4 4 4 4 4 4 4 3 4 4 4 4 4 4 4 4 4 4 4 4 4 4 4 4 4 4 4 4 4 4 4 4 4 4 4 4 4 4 4 4 4 4 4 4 4 4 4 4 4 4 4 4 4 4 4 4 4 4 4 4 4 4 4 4 4 4 4 4 4 4 4 4 4 4 4 4 4 4 4 4 3 3 4 3 3 3 4 4 4 4 4 4 4 4 4 4 4 4 4 4 4 4 4 4 4 4 4
8 8 17 3 3 3 3 3 3 3 18 8 8 8 8 8 8 8 8 8 8 8 8 8 8 8 8 8 8 8 8 8 8 8 8 8 8 8 8 8 8 8 8 8 8 8 8 8 8 8 8 8 8 8 17 3 3 3 3 3 3 3 3 3 3 3 3 3 3 3 3 3 18 8 8 8 8 8 8 8 8 8 8 8 8 8 8 8 8 8 8 8 8 8 8 8 8 17 3 3 18 8 8 8 8 8 8 17 3 3 3 3 3 3 3 3 3 3 3 18 8 8 8 8 8 8 8 8 8 8 8 17 3 3 3 3 3 3 3 18 8 8 8 8 8 8 8 8 17 3 3 3 3 3 3 18 8 8 8 8 8 8 8 8 8 8 17 3 3 3 3 3 3 3 3 3 3 3 3 3 18 8 8 8 8 8 8 8 8 8 8 8 8 8 8 8 8 8 8 8
0 0 0 17 3 3 3 3 3 18 23 0 0 0 0 0 0 0 0 0 0 0 0 0 0 0 0 0 0 0 0 0 0 0 0 0 0 0 0 0 0 0 0 0 0 0 0 0 0 0 0 0 0 0 21 17 3 3 3 3 3 3 3 3 3 3 3 3 3 3 3 18 23 0 0 0 0 0 0 0 0 0 0 0 0 0 0 0 0 0 0 0 0 0 0 0 0 21 17 18 23 0 0 0 0 0 0 21 17 3 3 3 3 3 3 3 3 3 18 23 0 0 0 0 0 0 0 0 0 0 0 21 17 3 3 3 3 3 18 0 0 0 0 0 0 0 0 0 0 17 3 3 3 3 18 23 0 28 1 1 1 1 25 0 0 0 21 17 3 3 3 3 3 3 3 3 3 3 3 18 23 0 0 0 0 0 0 0 0 0 0 0 0 0 0 0 0 0 0 0
0 0 0 0 17 3 3 3 18 23 0 0 0 28 1 1 1 1 1 1 1 1 1 1 25 0 0 0 0 0 0 0 0 0 0 0 0 0 0 0 0 0 0 0 0 0 0 0 0 0 0 0 0 0 0 21 17 3 3 3 3 3 3 3 3 3 3 3 3 3 18 0 0 0 0 28 1 1 1 1 1 25 0 0 0 0 28 1 1 1 25 0 0 0 0 0 0 0 21 23 0 0 0 0 0 0 0 0 21 17 3 3 3 3 3 3 3 18 23 0 0 0 0 0 0 0 0 0 0 0 0 0 21 17 3 3 3 18 0 0 0 28 1 1 1 25 0 0 0 0 17 3 3 18 23 0 28 19 3 3 3 3 16 0 0 0 0 21 17 3 3 3 3 3 3 3 3 3 18 23 0 0 0 0 0 0 0 0 0 0 0 0 0 0 0 0 0 0 0 0
0 0 0 0 21 8 8 8 0 0 0 0 28 19 3 3 3 3 3 3 3 3 3 3 16 0 0 0 0 0 0 0 0 0 0 0 0 0 0 0 0 0 0 0 0 0 0 0 0 0 0 0 0 0 0 0 21 17 3 3 3 3 3 3 3 3 3 3 3 18 0 0 0 0 28 19 3 3 3 3 3 16 0 0 0 0 19 3 3 3 16 0 0 0 0 0 0 0 0 0 0 0 0 0 0 0 0 0 0 21 17 3 3 3 3 3 18 23 0 0 0 0 0 0 0 0 0 0 0 0 0 0 0 21 17 3 18 0 0 0 28 19 3 3 3 20 25 0 0 0 21 8 8 23 0 28 19 3 3 3 3 3 16 0 0 0 0 0 21 17 3 3 3 3 3 3 3 18 23 0 0 0 0 0 0 0 0 0 0 0 0 0 0 0 0 0 0 0 0 0
0 0 0 0 0 0 0 0 0 0 0 0 11 3 3 3 3 3 3 3 3 3 3 3 16 0 0 0 0 0 0 0 0 0 0 0 0 0 0 0 0 0 0 0 0 0 0 0 0 0 0 0 0 0 0 0 0 21 17 3 3 3 3 3 3 3 3 3 18 0 0 0 0 28 19 3 3 3 3 3 3 16 0 0 0 19 3 3 3 3 16 0 0 0 0 0 0 0 0 0 0 0 0 0 0 0 0 0 0 0 21 8 8 8 8 8 23 0 0 0 0 0 0 0 0 0 0 0 0 0 0 0 0 0 21 8 23 0 0 28 19 3 3 3 3 3 20 25 0 0 0 0 0 0 1 19 3 3 3 3 3 3 16 0 0 0 0 0 0 21 17 3 3 3 3 3 18 23 0 0 0 0 0 0 0 0 0 0 0 0 0 0 0 0 0 0 0 0 0 0
0 0 0 0 0 0 0 0 0 0 0 0 11 3 3 3 3 3 3 3 3 3 3 18 23 0 0 0 0 0 0 0 0 0 0 0 0 0 0 0 0 0 0 0 0 0 0 0 0 0 0 0 0 0 0 0 0 0 21 17 3 3 3 3 3 3 3 18 0 0 0 0 28 19 3 3 3 3 3 3 3 16 0 0 19 3 3 3 3 3 16 0 0 0 0 0 0 0 0 0 0 0 0 0 0 0 0 0 0 0 0 0 0 0 0 0 0 0 0 0 0 0 0 0 0 0 0 0 0 0 0 0 0 0 0 0 0 0 28 19 3 3 3 3 3 3 3 20 25 0 0 0 28 19 3 3 3 3 3 3 3 3 16 0 0 0 0 0 0 0 21 17 3 3 3 18 23 0 0 0 0 0 0 0 0 0 0 0 0 0 0 0 0 0 0 0 0 0 0 0
0 0 0 28 1 1 1 1 1 25 0 0 21 17 3 3 3 3 3 3 3 3 18 0 0 0 0 0 0 0 0 0 0 0 0 0 0 0 0 0 0 0 0 0 0 0 0 0 0 0 0 0 0 0 0 0 0 0 0 21 17 3 3 3 3 3 18 0 0 0 0 28 19 3 3 3 3 3 3 3 3 16 0 11 3 3 3 3 3 3 16 0 0 0 0 0 0 0 0 0 0 0 0 0 0 0 0 0 0 28 1 1 1 1 1 1 25 0 0 0 0 0 0 0 0 0 0 0 0 0 0 0 0 0 0 0 0 28 19 3 3 3 3 3 3 3 3 3 20 25 0 0 21 17 3 3 3 3 3 3 3 3 16 0 0 0 0 0 0 0 0 21 8 8 8 23 0 0 0 0 0 0 0 0 0 0 0 0 0 0 0 0 0 0 0 0 0 0 0 0
0 0 28 19 3 3 3 3 3 20 25 0 0 21 17 3 3 3 3 3 3 18 0 0 0 0 0 0 0 0 0 0 0 0 0 0 0 0 0 0 0 0 0 0 0 0 0 0 0 0 0 0 0 0 0 0 0 0 0 0 21 8 8 8 8 8 0 0 0 0 28 19 3 3 3 3 3 3 3 3 3 16 0 11 3 3 3 3 3 3 16 0 0 0 0 0 0 0 0 0 0 0 0 0 0 0 0 0 28 19 4 4 4 4 4 4 20 25 0 0 0 0 0 0 0 0 0 0 0 0 0 0 0 0 0 0 28 19 3 3 3 3 3 3 3 3 3 3 3 20 25 0 0 21 17 3 3 3 3 3 3 3 16 0 0 0 0 0 0 0 0 28 1 1 1 25 0 0 0 0 0 0 0 0 0 0 0 0 0 0 0 0 0 0 0 0 0 0 0 0
0 28 19 3 3 3 3 3 3 3 20 25 0 0 21 17 3 3 3 3 18 0 0 0 0 0 0 0 0 0 0 0 0 0 0 0 0 0 0 0 0 0 0 0 0 0 0 0 0 0 0 0 0 0 0 0 0 0 0 0 0 0 0 0 0 0 0 0 0 28 19 3 3 3 3 3 3 3 3 3 3 16 0 21 17 3 3 3 3 3 16 0 0 0 0 0 0 0 0 0 0 0 0 0 0 0 0 28 19 4 4 4 4 4 4 4 4 20 25 0 0 0 0 0 0 0 0 0 0 0 0 0 0 0 0 28 19 3 3 3 3 3 3 3 3 3 3 3 3 3 20 25 0 0 21 17 3 3 3 3 3 3 16 0 0 0 0 0 0 0 28 19 3 3 3 20 25 0 0 0 0 0 0 0 0 0 0 0 0 0 0 0 0 0 0 0 0 0 0 0
28 19 3 3 3 3 3 3 3 3 3 20 25 0 0 21 8 8 8 8 23 0 0 0 0 0 0 0 0 0 0 0 0 0 0 0 0 0 0 0 0 0 0 0 0 0 0 0 0 0 0 0 0 0 0 0 0 0 0 0 0 1 1 1 1 1 1 1 1 19 3 3 3 3 3 3 3 3 3 3 3 16 0 0 21 8 8 8 8 8 23 0 0 0 0 0 0 0 28 25 0 0 0 0 0 0 28 19 4 4 4 4 4 4 4 4 4 4 20 25 0 0 0 0 0 0 0 0 0 0 0 0 0 0 28 19 3 3 3 3 3 3 3 3 3 3 3 3 3 3 3 20 25 0 0 21 8 8 8 8 8 8 23 0 0 0 0 0 0 28 19 3 3 3 3 3 20 25 0 0 0 0 0 0 0 0 0 0 0 0 0 0 0 0 0 0 0 0 0 0
19 3 3 3 3 3 3 3 3 3 3 3 20 25 0 0 0 0 0 0 0 0 0 0 0 0 0 0 0 0 0 0 0 0 0 0 0 0 0 0 0 0 0 0 0 0 0 0 0 0 0 0 0 0 0 0 0 0 0 0 19 3 3 3 3 3 3 3 3 3 3 3 3 3 3 3 3 3 3 3 3 16 0 0 0 0 0 0 0 0 0 0 0 0 0 0 0 0 19 20 0 0 0 0 0 28 19 4 4 4 4 4 4 4 4 4 4 4 4 20 25 0 0 0 0 0 0 0 0 0 0 0 0 28 19 3 3 3 3 3 3 3 3 3 3 3 3 3 3 3 3 3 20 25 0 0 0 0 0 0 0 0 0 0 0 0 0 0 28 19 3 3 3 3 3 3 3 20 25 0 0 0 0 0 0 0 0 0 0 0 0 0 0 0 0 0 0 0 0 0
3 3 3 3 3 3 3 3 3 3 3 3 3 20 1 1 1 1 1 1 1 1 1 1 1 1 1 1 1 1 1 1 1 1 1 1 1 1 1 1 1 1 1 1 1 1 1 1 1 1 1 1 1 1 1 1 1 1 1 19 3 3 3 3 3 3 3 3 3 3 3 3 3 3 3 3 3 3 3 3 3 20 1 1 1 1 1 1 1 1 1 1 1 1 1 1 1 19 3 3 20 1 1 1 1 19 4 4 4 4 4 4 4 4 4 4 4 4 4 4 20 1 1 1 1 1 1 1 1 1 1 1 1 19 3 3 3 3 3 3 3 3 3 3 3 3 3 3 3 3 3 3 3 20 1 1 1 1 1 1 1 1 1 1 1 1 1 1 19 3 3 3 3 3 3 3 3 3 20 1 1 1 1 1 1 1 1 1 1 1 1 1 1 1 1 1 1 1 1 1
3 3 3 3 3 3 3 3 3 3 3 3 3 3 3 3 3 3 3 3 3 3 3 3 3 3 3 3 3 3 3 3 3 3 3 3 3 3 3 3 3 3 3 3 3 3 3 3 3 3 3 3 3 3 3 3 3 3 3 3 3 3 3 3 3 3 3 3 3 3 3 3 3 3 3 3 3 3 3 3 3 3 3 3 3 3 3 3 6 6 6 6 6 6 6 6 6 6 6 6 6 6 6 6 6 6 6 6 6 6 6 6 6 6 6 6 6 6 6 6 6 6 6 6 6 6 6 6 6 6 6 6 6 6 6 6 6 6 6 6 6 6 6 6 6 6 6 6 6 6 6 6 6 6 6 6 6 6 6 6 6 6 6 6 6 6 6 6 6 6 6 3 6 6 6 6 3 3 6 6 6 6 6 6 6 6 6 6 6 6 6 6 6 6 6 6 6 6 6 6
